. . . . . . . . . . . . . . . . . . . . . . . . . . . .
. # # # # # # # # # # # # . . # # # # # # # # # # # # .
. # . . . . # . . . . . # . . # . . . . . # . . . . # .
. # . . . . # . . . . . # . . # . . . . . # . . . . # .
. # . . . . # . . . . . # . . # . . . . . # . . . . # .
. # # # # # # # # # # # # # # # # # # # # # # # # # # .
. # . . . . # . . # . . . . . . . . # . . # . . . . # .
. # . . . . # . . # . . . . . . . . # . . # . . . . # .
. # # # # # # . . # # # # . . # # # # . . # # # # # # .
. . . . . . # . . . . . # . . # . . . . . # . . . . . .
. . . . . . # . . . . . # . . # . . . . . # . . . . . .
. . . . . . # . . # # # # # # # # # # . . # . . . . . .
. . . . . . # . . # . . . . . . . . # . . # . . . . . .
. . . . . . # . . # . . . . . . . . # . . # . . . . . .
# # # # # # # # # # . . . . . . . . # # # # # # # # # #
. . . . . . # . . # . . . . . . . . # . . # . . . . . .
. . . . . . # . . # . . . . . . . . # . . # . . . . . .
. . . . . . # . . # # # # # # # # # # . . # . . . . . .
. . . . . . # . . # . . . . . . . . # . . # . . . . . .
. . . . . . # . . # . . . . . . . . # . . # . . . . . .
. # # # # # # # # # # # # . . # # # # # # # # # # # # .
. # . . . . # . . . . . # . . # . . . . . # . . . . # .
. # . . . . # . . . . . # . . # . . . . . # . . . . # .
. # # # . . # # # # # # # # # # # # # # # # . . # # # .
. . . # . . # . . # . . . . . . . . # . . # . . # . . .
. . . # . . # . . # . . . . . . . . # . . # . . # . . .
. # # # # # # . . # # # # . . # # # # . . # # # # # # .
. # . . . . . . . . . . # . . # . . . . . . . . . . # .
. # . . . . . . . . . . # . . # . . . . . . . . . . # .
. # # # # # # # # # # # # # # # # # # # # # # # # # # .
. . . . . . . . . . . . . . . . . . . . . . . . . . . .
